ArduinoTimer	KEYWORD1
Reset	KEYWORD2
EllapsedMilliseconds	KEYWORD2
EllapsedSeconds	KEYWORD2
TimePassed_Milliseconds	KEYWORD2
TimePassed_Seconds	KEYWORD2
TimePassed_Minutes	KEYWORD2
TimePassed_Hours	KEYWORD2
StartTime	KEYWORD2
CircularBuffer	KEYWORD1
ElementSize	KEYWORD2
IsEmpty	KEYWORD2
Add	KEYWORD2
Add	KEYWORD2
Head	KEYWORD2
Tail	KEYWORD2
PopTail	KEYWORD2
DropRecords	KEYWORD2
Clear	KEYWORD2
CountStored	KEYWORD2
MaxSize	KEYWORD2
GetTailIndex	KEYWORD2
Dump	KEYWORD2
ForwardIterator	KEYWORD1
CurrentValue	KEYWORD2
CurrentIndex	KEYWORD2
Next	KEYWORD2
AtEnd	KEYWORD2
Previous	KEYWORD2
ReverseIterator	KEYWORD1
CommandHandler	KEYWORD1
Process	KEYWORD2
AddCommand	KEYWORD2
SetDefaultHandler	KEYWORD2
ClearCommands	KEYWORD2
AddVariable	KEYWORD2
DispatchCommand	KEYWORD2
CommandParameter	KEYWORD1
GetSource	KEYWORD2
NextParameter	KEYWORD2
RemainingParameters	KEYWORD2
NextParameterAsInteger	KEYWORD2
NextParameterAsLong	KEYWORD2
NextParameterAsUnsignedLong	KEYWORD2
NextParameterAsDouble	KEYWORD2
DataStore	KEYWORD1
Send	KEYWORD2
EEPROMStore	KEYWORD1
Load	KEYWORD2
Save	KEYWORD2
Reset	KEYWORD2
ExponentialFilter	KEYWORD1
SetWeight	KEYWORD2
GetWeight	KEYWORD2
Current	KEYWORD2
Filter	KEYWORD2
SpecialParameters	KEYWORD1
CurrentTime	KEYWORD2

InterfacePanel	KEYWORD1
SetText	KEYWORD2
SetProgress	KEYWORD2
SetNumber	KEYWORD2
SetListIndex	KEYWORD2
SetListValue	KEYWORD2
SetCheck	KEYWORD2
ShowControl	KEYWORD2
HideControl	KEYWORD2
ClearCheck	KEYWORD2
CallCommand	KEYWORD2
GetValue	KEYWORD2

Map	KEYWORD1
SendData	KEYWORD2

Message	KEYWORD1
Begin	KEYWORD2
End	KEYWORD2
Send	KEYWORD2
Clear	KEYWORD2
Flush	KEYWORD2
StartLogging	KEYWORD2
LogTo	KEYWORD2
StopLogging	KEYWORD2

Table	KEYWORD1
SendData	KEYWORD2
SetDescription	KEYWORD2
ClearAllRows	KEYWORD2
ClearRow	KEYWORD2
GetData	KEYWORD2

TimePlot	KEYWORD1
SendData	KEYWORD2
SendFloatData	KEYWORD2
SetCursorVisibility	KEYWORD2
SetCursorPosition	KEYWORD2
SetCursorPositionToNow	KEYWORD2

XYPlot	KEYWORD1
SendData	KEYWORD2

Report	KEYWORD1
EnablePeriodicReports	KEYWORD2
GenerateNow	KEYWORD2

RecordTable	KEYWORD1
AddRow	KEYWORD2
AddRowFromArray	KEYWORD2
AddRowWithIds	KEYWORD2
AddRowFromArrayWithIds	KEYWORD2
UpdateRow	KEYWORD2
UpdateRowFromArray	KEYWORD2
UpdateRowFromArrayWithIds	KEYWORD2
SetValue	KEYWORD2
ClearAllRows	KEYWORD2
ClearRow	KEYWORD2
SetNumberOfDecimalPlaces	KEYWORD2

Audio	KEYWORD1
Speak	KEYWORD2
PlayAudioClip	KEYWORD2
Stop	KEYWORD2
